11111111111111111111
100000000F0000000001
1P00000000000E000001
100C00000F000C000001
11111111111111111111























