111111111111111111
100000C000000F0001
100001000000F00C01
100P000000000F0001
100000C0000000F001
10000000111000F0E1
111111111111111111
