111111111
1P0000EC1
111111111
