11111111111111111111111111111111111111111111111111111111
100000001000F00011110000001000F0000000010100001111100111
10001000000000101000111100000001100000100000001F11100001
1000F0000000000FF0000000000010000000011000F0000C00000EC1
100000000000000000C00000110000000C0000000010000000000001
1000P00000000000F00000F000C0000FFF0000000000000000011111
10000000010000010000000000000000001111110000000000000101
11111111111111111111111111111111111111111111111111111111
